###############
#E..#....#....#
#.#.#.##.#.##.#
#.#...#..#....#
#.#.###.#####.#
#...#.........#
###.#.#####.###
#...#F....#...#
#.###.###.#.#.#
#.....#.F.#.#.#
#.#####.###.#.#
#.......#.....#
###.#####.###.#
#.....#.......#
#############S#
