##E##
#...#
#...#
#...#
##S##
