##E#####
#......#
#......#
#......#
##S#####
