##E######
#.......#
#.......#
#.......#
#.......#
#####S###
