########E#
#..S#....#
#..#...#.#
#P#.#..#.#
#.....##.#
###.#.V.##
#...#...F#
###....#.#
#...#..#.#
##########
