#####E####
##.##.####
#......###
#.##..#.##
##.......#
#.#.##.#.#
#P.V#....#
#...##.#.#
#SF#....##
##########
