#####E####
#.#.#...##
#.....#..#
#.#.#.#V##
#....##..#
##.#...#.#
#..#.##..#
#.#F.#S#.#
#..#P...##
##########
