##E#######
#....V...#
##.#..##.#
#....#...#
##.###.#.#
#........#
###.##.#.#
#P#...#S.#
#F......##
##########
