#E########
#...#.#.##
#....P...#
#.V#..#.##
#.#...#..#
#.#..#..##
#.....#.F#
#..###.#.#
#.#S.....#
##########
