######E###
#...##...#
#.#....#.#
#...##..##
#........#
#...#..F.#
#...#....#
#.#.#P.#.#
#S...#V#.#
##########
