####E#####
#.....V.##
##.#.#P..#
#........#
#.#....#.#
#...#.#..#
#......#.#
#.F.#.#..#
##.#...#S#
##########
