#######E#####
#...#P......#
#...####....# 
#F...#......#
#V#.........#
#.######.#..#
#.P..#......#
#....#F#....#
#V..........#
########S####