########E#
#......#.#
#...##...#
#.#.#.#.##
#.P#....##
#....##..#
###F#.V#.#
#S##.#...#
#......#.#
##########
